COUNTRY,ISO3,WHO_REGION,Cases - cumulative total,Cases - cumulative total per 100000 population,Cases - newly reported in last 7 days,Cases - newly reported in last 7 days per 100000 population,Cases - newly reported in last 24 hours,Deaths - cumulative total,Deaths - cumulative total per 100000 population,Deaths - newly reported in last 7 days,Deaths - newly reported in last 7 days per 100000 population,Deaths - newly reported in last 24 hours,Number of Male Cases,Number of Female Cases,Number of Male Deaths,Number of Female Deaths,Total Cases Children (5-17),Total Cases Adults (18+),Total Deaths Children (5-17),Total Deaths Adults (18+)
Afghanistan,AFG,EMRO,198876,510.877,853,2.191,0,7799,20.034,3,0.008,0,26242,172634,4423,3376,172054,26822,3534,4265
Albania,ALB,EURO,331027,11502.78,312,10.842,44,3589,124.713,0,0,0,210267,120760,1496,2093,215426,115601,3489,100
Algeria,DZA,AFRO,270668,617.244,37,0.084,0,6879,15.687,0,0,0,44830,225838,4976,1903,10419,260249,6210,669
American Samoa,ASM,WPRO,8247,14941.029,0,0,0,34,61.598,0,0,0,1715,6532,31,3,2277,5970,17,17
Andorra,AND,EURO,46227,59829.159,80,103.54,0,155,200.608,0,0,0,29972,16255,124,31,45441,786,119,36
Angola,AGO,AFRO,103131,313.79,0,0,0,1917,5.833,0,0,0,27020,76111,1313,604,16185,86946,1394,523
Anguilla,AIA,AMRO,3865,25763.232,7,46.66,0,12,79.989,0,0,0,42,3823,10,2,1716,2149,4,8
Antigua and Barbuda,ATG,AMRO,9089,9281.214,0,0,0,146,149.088,0,0,0,1801,7288,128,18,1406,7683,94,52
Argentina,ARG,AMRO,9708420,21480.814,4482,9.917,0,129897,287.41,42,0.093,0,2501342,7207078,19196,110701,4505924,5202496,116303,13594
Armenia,ARM,EURO,442875,14945.664,1431,48.292,0,8683,293.024,4,0.135,0,403863,39012,7689,994,270905,171970,3772,4911
Aruba,ABW,AMRO,42970,40246.895,0,0,0,230,215.424,2,1.873,0,1561,41409,81,149,3150,39820,32,198
Australia,AUS,WPRO,10191312,39966.111,0,0,0,14853,58.247,0,0,0,8667984,1523328,12875,1978,8340505,1850807,7943,6910
Austria,AUT,EURO,5118512,57504.496,68105,765.133,12317,20738,232.983,23,0.258,1,4568102,550410,2833,17905,153883,4964629,19150,1588
Azerbaijan,AZE,EURO,821311,8100.373,1012,9.981,149,9913,97.769,13,0.128,3,262457,558854,5431,4482,768959,52352,2886,7027
Bahamas,BHS,AMRO,37276,9479.102,42,10.68,0,833,211.828,0,0,0,35752,1524,512,321,30836,6440,665,168
Bahrain,BHR,EMRO,679912,39957.804,2245,131.937,0,1520,89.329,0,0,0,131189,548723,24,1496,663863,16049,705,815
Bangladesh,BGD,SEARO,2025197,1229.707,4429,2.689,708,29363,17.829,16,0.01,1,680680,1344517,5649,23714,573555,1451642,732,28631
Barbados,BRB,AMRO,102516,35673.249,150,52.197,28,559,194.519,0,0,0,13378,89138,167,392,101847,669,126,433
Belarus,BLR,EURO,994037,10519.666,0,0,0,7118,75.328,0,0,0,58077,935960,2894,4224,153259,840778,1805,5313
Belgium,BEL,EURO,4544505,39440.474,15188,131.812,6,32673,283.56,24,0.208,0,196639,4347866,1719,30954,456655,4087850,20657,12016
Belize,BLZ,AMRO,68826,17309.143,83,20.874,0,683,171.769,0,0,0,66442,2384,199,484,68087,739,142,541
Benin,BEN,AFRO,27638,227.976,0,0,0,163,1.345,0,0,0,24481,3157,96,67,14546,13092,126,37
Bermuda,BMU,AMRO,18154,29152.281,32,51.387,32,148,237.663,0,0,0,14780,3374,51,97,5251,12903,37,111
Bhutan,BTN,SEARO,61969,8031.151,23,2.981,0,21,2.722,0,0,0,16228,45741,9,12,55291,6678,20,1
Bolivia (Plurinational State of),BOL,AMRO,1108129,9493.078,546,4.677,74,22234,190.473,5,0.043,1,551758,556371,12205,10029,664453,443676,16770,5464
Bonaire,BES,AMRO,9419,45034.664,18,86.063,0,31,148.219,0,0,0,1317,8102,13,18,4832,4587,22,9
Bosnia and Herzegovina,BIH,EURO,398668,12151.493,447,13.625,94,16136,491.829,17,0.518,1,117052,281616,1423,14713,262028,136640,15841,295
Botswana,BWA,AFRO,326288,13874.99,0,0,0,2781,118.259,0,0,0,230704,95584,208,2573,114247,212041,235,2546
Brazil,BRA,AMRO,34654190,16303.296,46243,21.755,7613,685927,322.699,323,0.152,46,20941754,13712436,631766,54161,18339976,16314214,113146,572781
British Virgin Islands,VGB,AMRO,7305,24159.143,0,0,0,64,211.661,0,0,0,4885,2420,60,4,1130,6175,10,54
Brunei Darussalam,BRN,WPRO,227756,52061.013,0,0,0,132,30.173,1,0.229,0,98536,129220,69,63,92220,135536,96,36
Bulgaria,BGR,EURO,1258670,18106.499,4736,68.129,752,37714,542.532,20,0.288,3,824442,434228,27488,10226,330125,928545,15690,22024
Burkina Faso,BFA,AFRO,21631,103.481,0,0,0,387,1.851,0,0,0,19251,2380,166,221,15877,5754,125,262
Burundi,BDI,AFRO,50193,422.117,85,0.715,0,15,0.126,0,0,0,28862,21331,12,3,48131,2062,0,15
Cabo Verde,CPV,AFRO,62371,11218.068,13,2.338,0,410,73.743,0,0,0,27045,35326,19,391,23857,38514,310,100
Cambodia,KHM,WPRO,137861,824.579,37,0.221,0,3056,18.279,0,0,0,135035,2826,647,2409,24377,113484,2473,583
Cameroon,CMR,AFRO,121652,458.271,0,0,0,1935,7.289,0,0,0,86337,35315,411,1524,57848,63804,619,1316
Canada,CAN,AMRO,4233468,11216.816,17326,45.906,0,44992,119.209,195,0.517,0,1724141,2509327,39128,5864,2934009,1299459,20190,24802
Cayman Islands,CYM,AMRO,30661,46653.987,116,176.506,0,32,48.691,1,1.522,0,14820,15841,28,4,14575,16086,31,1
Central African Republic,CAF,AFRO,14912,308.752,0,0,0,113,2.34,0,0,0,11388,3524,57,56,12172,2740,69,44
Chad,TCD,AFRO,7581,46.153,10,0.061,0,193,1.175,0,0,0,4669,2912,38,155,2540,5041,79,114
Chile,CHL,AMRO,4620377,24169.954,25858,135.267,4083,61141,319.839,167,0.874,49,2771859,1848518,10692,50449,171501,4448876,27369,33772
China,CHN,WPRO,7572246,514.668,249151,16.934,0,26330,1.79,462,0.031,0,4586968,2985278,4551,21779,745392,6826854,2021,24309
Colombia,COL,AMRO,6306552,12394.249,990,1.946,0,141769,278.618,23,0.045,0,1557306,4749246,124492,17277,1981890,4324662,80544,61225
Comoros,COM,AFRO,8471,974.125,0,0,0,160,18.399,0,0,0,2843,5628,29,131,676,7795,44,116
Congo,COG,AFRO,24775,448.978,0,0,0,386,6.995,0,0,0,1643,23132,173,213,12050,12725,230,156
Cook Islands,COK,WPRO,6389,36375.541,0,0,0,1,5.693,0,0,0,78,6311,0,1,4362,2027,0,1
Costa Rica,CRI,AMRO,1117989,21946.665,6020,118.176,0,8970,176.085,37,0.726,0,1113015,4974,420,8550,692199,425790,2010,6960
Côte d’Ivoire,CIV,AFRO,87208,330.605,114,0.432,49,826,3.131,3,0.011,2,69682,17526,293,533,21585,65623,615,211
Croatia,HRV,EURO,1231575,30348.076,4378,107.881,909,16902,416.494,41,1.01,10,552036,679539,11554,5348,543612,687963,4303,12599
Cuba,CUB,AMRO,1111179,9810.335,83,0.733,9,8530,75.309,0,0,0,107474,1003705,1445,7085,707531,403648,2966,5564
Curaçao,CUW,AMRO,45368,27647.736,11,6.704,0,287,174.901,0,0,0,6974,38394,56,231,20031,25337,216,71
Cyprus,CYP,EURO,587994,66215.168,2681,301.913,2681,1182,133.107,2,0.225,2,176321,411673,846,336,302459,285535,1058,124
Czechia,CZE,EURO,4104162,38378.394,17088,159.791,3670,41090,384.236,70,0.655,2,2301849,1802313,30556,10534,615341,3488821,36522,4568
Democratic Republic of the Congo,COD,AFRO,92892,103.719,13,0.015,0,1443,1.611,1,0.001,0,83055,9837,1138,305,58330,34562,14,1429
Denmark,DNK,EURO,3298293,56644.809,8315,142.802,1348,7065,121.334,44,0.756,8,915913,2382380,2639,4426,1170611,2127682,4581,2484
Djibouti,DJI,EMRO,15690,1588.057,0,0,0,189,19.13,0,0,0,666,15024,102,87,8666,7024,183,6
Dominica,DMA,AMRO,15747,21873.568,895,1243.211,0,74,102.791,6,8.334,0,8504,7243,32,42,3720,12027,24,50
Dominican Republic,DOM,AMRO,644356,5939.909,0,0,0,4384,40.413,0,0,0,545922,98434,2607,1777,345863,298493,4223,161
Ecuador,ECU,AMRO,1003778,5689.366,1325,7.51,0,35894,203.446,5,0.028,0,921142,82636,21063,14831,513358,490420,27152,8742
Egypt,EGY,EMRO,515371,503.615,10,0.01,0,24797,24.231,0,0,0,450686,64685,20119,4678,499800,15571,22406,2391
El Salvador,SLV,AMRO,201785,3110.987,0,0,0,4229,65.2,0,0,0,60633,141152,1446,2783,91655,110130,1648,2581
Equatorial Guinea,GNQ,AFRO,16915,1205.644,2,0.143,0,183,13.044,0,0,0,3874,13041,176,7,9094,7821,157,26
Eritrea,ERI,AFRO,10168,286.712,0,0,0,103,2.904,0,0,0,6104,4064,3,100,4831,5337,75,28
Estonia,EST,EURO,601993,45297.507,584,43.944,0,2681,201.734,14,1.053,0,442804,159189,917,1764,208867,393126,1645,1036
Eswatini,SWZ,AFRO,73390,6325.83,11,0.948,0,1422,122.569,0,0,0,73094,296,60,1362,66420,6970,54,1368
Ethiopia,ETH,AFRO,493510,429.275,20,0.017,0,7572,6.586,0,0,0,68507,425003,6245,1327,173093,320417,7304,268
Falkland Islands (Malvinas),FLK,AMRO,1930,55412.001,44,1263.279,0,0,0,0,0,0,365,1565,0,0,1028,902,0,0
Faroe Islands,FRO,EURO,34658,70926.021,0,0,0,28,57.301,0,0,0,33538,1120,1,27,1911,32747,0,28
Fiji,FJI,WPRO,68234,7611.621,0,0,0,878,97.942,0,0,0,40131,28103,616,262,30012,38222,700,178
Finland,FIN,EURO,1292940,23400.392,1861,33.681,0,5981,108.248,0,0,0,1134511,158429,273,5708,698066,594874,5038,943
France,FRA,EURO,34304599,52744.368,290601,446.808,51348,151503,232.94,212,0.326,33,2915700,31388899,114585,36918,6943091,27361508,127223,24280
French Guiana,GUF,AMRO,93974,31462.894,49,16.405,0,410,137.27,0,0,0,60299,33675,48,362,39692,54282,16,394
French Polynesia,PYF,WPRO,76599,27268.358,11,3.916,0,649,231.036,0,0,0,68961,7638,480,169,3520,73079,204,445
Gabon,GAB,AFRO,48691,2187.638,0,0,0,306,13.748,0,0,0,47072,1619,227,79,39669,9022,23,283
Gambia,GMB,AFRO,12442,514.841,27,1.117,0,372,15.393,0,0,0,6613,5829,172,200,4568,7874,190,182
Georgia,GEO,EURO,1780691,44638.077,0,0,0,16900,423.646,0,0,0,864981,915710,4331,12569,109915,1670776,5049,11851
Germany,DEU,EURO,33312373,40054.936,388140,466.701,51364,149948,180.298,87,0.105,14,2392931,30919442,46544,103404,7984963,25327410,55490,94458
Ghana,GHA,AFRO,169100,544.203,0,0,0,1459,4.695,0,0,0,65621,103479,743,716,9920,159180,1074,385
Gibraltar,GIB,EURO,20092,59636.105,23,68.267,0,108,320.56,0,0,0,11620,8472,76,32,13228,6864,11,97
Greece,GRC,EURO,4920192,45903.458,44775,417.733,0,33111,308.913,97,0.905,0,1144838,3775354,26019,7092,1020799,3899393,30672,2439
Greenland,GRL,EURO,11971,21086.099,0,0,0,21,36.99,0,0,0,7401,4570,12,9,7106,4865,19,2
Grenada,GRD,AMRO,19536,17361.784,20,17.774,0,237,210.624,1,0.889,0,994,18542,16,221,3476,16060,88,149
Guadeloupe,GLP,AMRO,192801,48185.313,804,200.938,0,989,247.173,3,0.75,0,84871,107930,202,787,97259,95542,267,722
Guam,GUM,WPRO,48842,28939.12,0,0,0,401,237.594,0,0,0,25531,23311,180,221,29666,19176,128,273
Guatemala,GTM,AMRO,1122517,6265.595,5153,28.763,1286,19779,110.401,42,0.234,4,542637,579880,4420,15359,902616,219901,7730,12049
Guernsey,GGY,EURO,31309,48565.18,210,325.743,0,63,97.723,1,1.551,0,14107,17202,12,51,22891,8418,31,32
Guinea,GIN,AFRO,37652,286.702,0,0,0,449,3.419,0,0,0,20374,17278,343,106,12835,24817,127,322
Guinea-Bissau,GNB,AFRO,8796,446.951,0,0,0,175,8.892,0,0,0,6445,2351,109,66,1090,7706,87,88
Guyana,GUY,AMRO,71331,9068.822,44,5.594,9,1281,162.863,0,0,0,29160,42171,1169,112,10841,60490,845,436
Haiti,HTI,AMRO,33702,295.566,0,0,0,857,7.516,0,0,0,610,33092,666,191,16437,17265,845,12
Honduras,HND,AMRO,456391,4607.866,285,2.877,0,10993,110.989,1,0.01,0,51087,405304,1683,9310,199968,256423,9028,1965
Hungary,HUN,EURO,2094142,21435.451,11392,116.607,0,47503,486.236,46,0.471,0,614275,1479867,34225,13278,1618767,475375,47158,345
Iceland,ISL,EURO,205637,56472.892,134,36.8,0,213,58.495,0,0,0,16409,189228,153,60,93044,112593,102,111
India,IND,SEARO,44587307,3230.954,28882,2.093,3947,528629,38.306,180,0.013,18,3307370,41279937,39048,489581,28249906,16337401,439135,89494
Indonesia,IDN,SEARO,6431624,2351.396,12230,4.471,1857,158112,57.806,126,0.046,19,3301869,3129755,35280,122832,5141094,1290530,90269,67843
Iran (Islamic Republic of),IRN,EMRO,7547968,8986.431,2617,3.116,0,144416,171.938,58,0.069,0,5690603,1857365,1296,143120,1402835,6145133,91543,52873
Iraq,IRQ,EMRO,2459505,6114.75,0,0,0,25352,63.029,0,0,0,1660135,799370,11314,14038,2285409,174096,21914,3438
Ireland,IRL,EURO,1663653,33511.393,1090,21.956,0,7942,159.978,20,0.403,0,1096855,566798,1941,6001,1648479,15174,5105,2837
Isle of Man,IMN,EURO,38008,44698.466,0,0,0,116,136.419,0,0,0,11986,26022,26,90,36073,1935,15,101
Israel,ISR,EURO,4661944,53860.804,6196,71.584,1485,11698,135.15,9,0.104,0,3403103,1258841,4009,7689,160284,4501660,8542,3156
Italy,ITA,EURO,22432803,37612.749,191434,320.975,37521,177054,296.864,279,0.468,30,13523950,8908853,108043,69011,15524262,6908541,11684,165370
Jamaica,JAM,AMRO,151791,5126.053,386,13.035,0,3314,111.915,15,0.507,0,39550,112241,2847,467,113319,38472,2565,749
Japan,JPN,WPRO,21187043,16751.768,268200,212.055,0,44551,35.225,374,0.296,0,11279669,9907374,21182,23369,4258775,16928268,1654,42897
Jersey,JEY,EURO,59874,55543.805,0,0,0,138,128.02,0,0,0,34028,25846,27,111,21226,38648,58,80
Jordan,JOR,EMRO,1746997,17122.161,1965,19.259,0,14122,138.408,6,0.059,0,57497,1689500,11133,2989,841270,905727,7659,6463
Kazakhstan,KAZ,EURO,1483609,7901.327,578,3.078,97,19050,101.455,2,0.011,0,1370925,112684,13961,5089,776026,707583,602,18448
Kenya,KEN,AFRO,338424,629.377,45,0.084,4,5678,10.56,3,0.006,0,71845,266579,1850,3828,76663,261761,1002,4676
Kiribati,KIR,WPRO,3430,2871.518,0,0,0,13,10.883,0,0,0,2760,670,1,12,2608,822,9,4
Kosovo,XKX,EURO,272015,15148.418,33,1.838,6,3189,177.594,0,0,0,32033,239982,1005,2184,254465,17550,1788,1401
Kuwait,KWT,EMRO,658520,15419.952,0,0,0,2563,60.015,0,0,0,137762,520758,1423,1140,205252,453268,1469,1094
Kyrgyzstan,KGZ,EURO,206083,3158.752,85,1.303,0,2991,45.845,0,0,0,40588,165495,280,2711,84685,121398,125,2866
Lao People's Democratic Republic,LAO,WPRO,215821,2966.383,206,2.831,0,757,10.405,0,0,0,92231,123590,699,58,183827,31994,345,412
Latvia,LVA,EURO,929051,48700.696,8506,445.883,1375,5990,313.995,10,0.524,6,921761,7290,798,5192,282814,646237,915,5075
Lebanon,LBN,EMRO,1215511,17808.524,950,13.919,0,10674,156.385,8,0.117,0,772973,442538,3313,7361,752297,463214,8870,1804
Lesotho,LSO,AFRO,34490,1609.99,0,0,0,706,32.956,0,0,0,16510,17980,443,263,23325,11165,400,306
Liberia,LBR,AFRO,7961,157.404,0,0,0,294,5.813,0,0,0,4984,2977,145,149,599,7362,114,180
Libya,LBY,EMRO,506991,7378.394,42,0.611,0,6437,93.68,0,0,0,57490,449501,1311,5126,229260,277731,261,6176
Liechtenstein,LIE,EURO,19644,50698.119,106,273.57,0,85,219.372,0,0,0,5600,14044,52,33,8246,11398,85,0
Lithuania,LTU,EURO,1250158,44742.94,7301,261.302,984,9320,333.561,5,0.179,0,95982,1154176,547,8773,1082279,167879,8306,1014
Luxembourg,LUX,EURO,291758,46598.67,1927,307.774,378,1129,180.32,2,0.319,0,233919,57839,603,526,105789,185969,1034,95
Madagascar,MDG,AFRO,66676,240.786,16,0.058,0,1410,5.092,0,0,0,63841,2835,1020,390,18352,48324,1363,47
Malawi,MWI,AFRO,88005,460.038,8,0.042,0,2680,14.009,0,0,0,47086,40919,1299,1381,3401,84604,2280,400
Malaysia,MYS,WPRO,4837005,14944.711,10785,33.322,0,36365,112.356,23,0.071,0,3986490,850515,34375,1990,1017869,3819136,23953,12412
Maldives,MDV,SEARO,185042,34232.551,38,7.03,0,308,56.98,0,0,0,130605,54437,148,160,170191,14851,58,250
Mali,MLI,AFRO,32635,161.154,43,0.212,13,742,3.664,2,0.01,1,14615,18020,95,647,10642,21993,225,517
Malta,MLT,EURO,114652,22281.388,118,22.932,0,806,156.637,2,0.389,0,74875,39777,786,20,24356,90296,90,716
Marshall Islands,MHL,WPRO,15305,25855.661,81,136.838,0,17,28.719,0,0,0,14819,486,15,2,868,14437,17,0
Martinique,MTQ,AMRO,220192,58676.402,663,176.675,0,1042,277.67,6,1.599,0,108178,112014,726,316,63384,156808,647,395
Mauritania,MRT,AFRO,62802,1350.68,15,0.323,0,994,21.378,0,0,0,17878,44924,232,762,52831,9971,661,333
Mauritius,MUS,AFRO,262648,20652.194,231,18.164,0,1026,80.675,0,0,0,198124,64524,382,644,201972,60676,1011,15
Mexico,MEX,AMRO,7082034,5492.812,1388,1.077,0,330046,255.983,13,0.01,0,4128070,2953964,261568,68478,1553967,5528067,114377,215669
Micronesia (Federated States of),FSM,WPRO,10814,9401.598,757,658.129,0,31,26.951,0,0,0,405,10409,3,28,10481,333,1,30
Monaco,MCO,EURO,14622,37259.199,81,206.401,14,63,160.534,0,0,0,90,14532,48,15,10354,4268,49,14
Mongolia,MNG,WPRO,982864,29980.996,313,9.548,0,2131,65.003,0,0,0,383869,598995,1768,363,727659,255205,2107,24
Montenegro,MNE,EURO,280014,44583.815,1026,163.36,175,2781,442.791,1,0.159,0,54772,225242,1830,951,139317,140697,751,2030
Montserrat,MSR,AMRO,1396,27925.585,15,300.06,0,8,160.032,0,0,0,586,810,5,3,763,633,6,2
Morocco,MAR,EMRO,1264920,3426.987,80,0.217,0,16278,44.101,0,0,0,677080,587840,4869,11409,1228312,36608,10476,5802
Mozambique,MOZ,AFRO,230312,736.87,93,0.298,0,2222,7.109,0,0,0,170709,59603,1435,787,58584,171728,1269,953
Myanmar,MMR,SEARO,622802,1144.65,2058,3.782,0,19458,35.762,5,0.009,0,350258,272544,19303,155,481222,141580,18950,508
Namibia,NAM,AFRO,166766,6563.252,0,0,0,4080,160.573,0,0,0,7219,159547,2347,1733,4823,161943,3768,312
Nauru,NRU,WPRO,4610,42551.228,0,0,0,1,9.23,0,0,0,2760,1850,0,1,4338,272,0,1
Nepal,NPL,SEARO,999742,3431.199,236,0.81,30,12018,41.247,2,0.007,0,675916,323826,1845,10173,222307,777435,3216,8802
Netherlands,NLD,EURO,8422336,48383.139,8807,50.593,0,22643,130.075,10,0.057,0,5847424,2574912,4835,17808,7817913,604423,13792,8851
New Caledonia,NCL,WPRO,74288,26020.498,31,10.858,0,314,109.983,0,0,0,69593,4695,191,123,12996,61292,57,257
New Zealand,NZL,WPRO,1762209,36543.423,9809,203.412,0,3037,62.979,54,1.12,0,859304,902905,2178,859,168450,1593759,2532,505
Nicaragua,NIC,AMRO,15070,227.487,25,0.377,0,245,3.698,0,0,0,4872,10198,25,220,4015,11055,222,23
Niger,NER,AFRO,9408,38.865,9,0.037,0,313,1.293,0,0,0,5317,4091,231,82,5214,4194,307,6
Nigeria,NGA,AFRO,265382,128.739,292,0.142,0,3155,1.531,0,0,0,3669,261713,1974,1181,55450,209932,2574,581
Niue,NIU,WPRO,80,4944.376,0,0,0,0,0,0,0,0,41,39,0,0,27,53,0,0
North Macedonia,MKD,EURO,342880,16457.871,411,19.728,0,9534,457.622,8,0.384,0,119453,223427,5311,4223,298544,44336,1524,8010
Northern Mariana Islands (Commonwealth of the),MNP,WPRO,13171,22883.403,5,8.687,0,40,69.496,0,0,0,2858,10313,2,38,11079,2092,10,30
Norway,NOR,EURO,1462233,27241.941,418,7.787,37,4098,76.347,33,0.615,0,1314318,147915,1615,2483,335146,1127087,1820,2278
occupied Palestinian territory,PSE,EMRO,702768,13775.945,0,0,0,5707,111.871,0,0,0,391784,310984,1434,4273,386432,316336,287,5420
Oman,OMN,EMRO,398424,7802.099,431,8.44,0,4628,90.627,0,0,0,293565,104859,3574,1054,379567,18857,2771,1857
Pakistan,PAK,EMRO,1572410,711.845,208,0.094,0,30612,13.858,1,0,0,1461760,110650,23956,6656,1176311,396099,17852,12760
Palau,PLW,WPRO,5460,30179.085,0,0,0,6,33.164,0,0,0,4028,1432,0,6,2866,2594,3,3
Panama,PAN,AMRO,986866,22871.826,1052,24.381,0,8497,196.928,7,0.162,0,830333,156533,1448,7049,915097,71769,1061,7436
Papua New Guinea,PNG,WPRO,44997,502.927,38,0.425,0,668,7.466,4,0.045,0,9200,35797,666,2,32241,12756,551,117
Paraguay,PRY,AMRO,716059,10039.33,50,0.701,0,19583,274.559,19,0.266,0,446451,269608,4919,14664,492522,223537,507,19076
Peru,PER,AMRO,4143085,12565.52,5771,17.503,981,216539,656.739,133,0.403,13,1227714,2915371,66505,150034,2648445,1494640,60163,156376
Philippines,PHL,WPRO,3943153,3598.389,13334,12.168,0,62882,57.384,187,0.171,0,3399839,543314,11941,50941,1509550,2433603,45308,17574
Pitcairn Islands,PCN,WPRO,4,8000,0,0,0,0,0,0,0,0,3,1,0,0,3,1,0,0
Poland,POL,EURO,6293558,16580.26,25504,67.19,3886,117569,309.733,138,0.364,30,4105862,2187696,101308,16261,2907253,3386305,1581,115988
Portugal,PRT,EURO,5480864,53233.415,8645,83.965,0,25008,242.893,22,0.214,0,2250260,3230604,8910,16098,1929000,3551864,24206,802
Puerto Rico,PRI,AMRO,955893,33412.867,7841,274.079,3515,5133,179.422,38,1.328,4,749903,205990,41,5092,99539,856354,333,4800
Qatar,QAT,EMRO,449602,15605.475,4575,158.796,0,682,23.672,0,0,0,426425,23177,580,102,132083,317519,533,149
Republic of Korea,KOR,WPRO,24740635,48256.345,175614,342.533,0,28364,55.324,287,0.56,0,15083183,9657452,22889,5475,18718011,6022624,26470,1894
Republic of Moldova,MDA,EURO,589437,14611.859,2414,59.842,0,11844,293.607,23,0.57,0,163757,425680,8053,3791,239835,349602,9221,2623
Romania,ROU,EURO,3267370,16904.12,8042,41.606,1174,67016,346.715,54,0.279,13,328730,2938640,12633,54383,80379,3186991,60941,6075
Russian Federation,RUS,EURO,20985756,14380.261,290862,199.31,37286,387269,265.372,718,0.492,106,17778536,3207220,19205,368064,6856476,14129280,53022,334247
Rwanda,RWA,AFRO,132488,1022.898,0,0,0,1466,11.319,0,0,0,99739,32749,590,876,83550,48938,19,1447
Saba,XCA,AMRO,730,37765.132,4,206.932,0,2,103.466,0,0,0,458,272,1,1,536,194,2,0
Saint Helena,SHN,AFRO,1521,25053.533,849,13984.517,0,0,0,0,0,0,217,1304,0,0,1091,430,0,0
Saint Kitts and Nevis,KNA,AMRO,6544,12302.602,1,1.88,0,46,86.479,0,0,0,5348,1196,9,37,3348,3196,46,0
Saint Lucia,LCA,AMRO,29408,16015.074,449,244.517,0,393,214.021,0,0,0,15886,13522,379,14,26115,3293,332,61
Saint Vincent and the Grenadines,VCT,AMRO,9448,8516.315,0,0,0,116,104.561,0,0,0,8391,1057,34,82,3306,6142,54,62
Samoa,WSM,WPRO,15925,8026.147,0,0,0,29,14.616,0,0,0,15206,719,26,3,2032,13893,5,24
San Marino,SMR,EURO,20763,61179.209,115,338.853,0,118,347.693,0,0,0,20525,238,13,105,15807,4956,72,46
Sao Tome and Principe,STP,AFRO,6230,2842.685,21,9.582,0,77,35.134,0,0,0,1566,4664,74,3,527,5703,49,28
Saudi Arabia,SAU,EMRO,816262,2344.646,653,1.876,0,9350,26.857,13,0.037,0,214030,602232,5490,3860,134777,681485,9027,323
Senegal,SEN,AFRO,88398,527.941,74,0.442,10,1968,11.754,0,0,0,88220,178,1027,941,16686,71712,316,1652
Serbia,SRB,EURO,2359530,34064.248,16060,231.856,2548,17000,245.427,78,1.126,17,2174912,184618,1442,15558,1678933,680597,13495,3505
Seychelles,SYC,AFRO,47141,47933.338,783,796.161,0,169,171.841,0,0,0,3127,44014,24,145,9267,37874,99,70
Sierra Leone,SLE,AFRO,7751,97.167,1,0.013,0,125,1.567,0,0,0,7055,696,98,27,4012,3739,13,112
Singapore,SGP,WPRO,1900761,32489.742,15902,271.813,0,1617,27.639,8,0.137,0,1248280,652481,1413,204,123258,1777503,422,1195
Sint Eustatius,XBA,AMRO,1196,38101.306,0,0,0,5,159.286,0,0,0,968,228,5,0,102,1094,0,5
Sint Maarten,SXM,AMRO,10863,25332.307,8,18.656,0,87,202.882,0,0,0,6562,4301,83,4,5348,5515,25,62
Slovakia,SVK,EURO,1843685,33780.284,2783,50.991,465,20457,374.816,14,0.257,2,1334907,508778,3994,16463,964445,879240,14365,6092
Slovenia,SVN,EURO,1181073,56352.64,14941,712.881,2613,8258,394.015,7,0.334,0,107139,1073934,3808,4450,590625,590448,6461,1797
Solomon Islands,SLB,WPRO,21544,3136.483,0,0,0,153,22.275,0,0,0,11026,10518,49,104,9482,12062,135,18
Somalia,SOM,EMRO,27207,171.186,0,0,0,1361,8.563,0,0,0,23808,3399,1007,354,19821,7386,994,367
South Africa,ZAF,AFRO,4018768,6776.019,1757,2.962,343,102169,172.266,0,0,0,1564518,2454250,64400,37769,1653370,2365398,3400,98769
South Sudan,SSD,AFRO,17780,158.839,0,0,0,138,1.233,0,0,0,9793,7987,71,67,7365,10415,107,31
Spain,ESP,EURO,13412263,28336.198,19067,40.283,0,114084,241.026,239,0.505,0,4696932,8715331,108868,5216,12330884,1081379,111676,2408
Sri Lanka,LKA,SEARO,670763,3132.467,78,0.364,0,16761,78.274,8,0.037,0,328138,342625,14784,1977,193011,477752,6958,9803
Sudan,SDN,EMRO,63280,144.313,0,0,0,4961,11.314,0,0,0,24347,38933,4937,24,10436,52844,996,3965
Suriname,SUR,AMRO,81106,13825.703,7,1.193,0,1385,236.093,0,0,0,51665,29441,914,471,28618,52488,240,1145
Sweden,SWE,EURO,2588441,25063.362,5072,49.111,1104,20225,195.835,16,0.155,0,2159704,428737,5231,14994,924268,1664173,19677,548
Switzerland,CHE,EURO,4084315,47192.32,8083,93.395,0,13565,156.737,1,0.012,0,3938094,146221,2048,11517,1095129,2989186,11679,1886
Syrian Arab Republic,SYR,EMRO,57288,327.348,27,0.154,0,3163,18.074,0,0,0,51358,5930,293,2870,40164,17124,1634,1529
Tajikistan,TJK,EURO,17786,186.482,0,0,0,125,1.311,0,0,0,7575,10211,43,82,7919,9867,59,66
Thailand,THA,SEARO,4681309,6706.749,4219,6.044,839,32764,46.94,72,0.103,9,4223139,458170,19250,13514,1625703,3055606,21948,10816
The United Kingdom,GBR,EURO,23672855,34871.481,45028,66.329,4869,190317,280.348,181,0.267,0,8486569,15186286,63043,127274,15184933,8487922,162542,27775
Timor-Leste,TLS,SEARO,23257,1763.972,9,0.683,4,138,10.467,0,0,0,2866,20391,65,73,21969,1288,67,71
Togo,TGO,AFRO,39053,471.727,152,1.836,19,285,3.443,1,0.012,0,38215,838,94,191,37438,1615,136,149
Tokelau,TKL,WPRO,0,0,0,0,0,0,0,0,0,0,0,0,0,0,0,0,0,0
Tonga,TON,WPRO,16182,15310.09,0,0,0,12,11.353,0,0,0,5346,10836,0,12,9036,7146,6,6
Trinidad and Tobago,TTO,AMRO,183181,13089.144,584,41.73,0,4207,300.61,12,0.857,0,106412,76769,30,4177,27831,155350,2860,1347
Tunisia,TUN,EMRO,1145686,9693.908,341,2.885,0,29249,247.482,3,0.025,0,366653,779033,2518,26731,1040939,104747,28602,647
Turkey,TUR,EURO,16873793,20007.09,0,0,0,101139,119.92,0,0,0,15911122,962671,35274,65865,6746928,10126865,25802,75337
Turkmenistan,TKM,EURO,0,0,0,0,0,0,0,0,0,0,0,0,0,0,0,0,0,0
Turks and Caicos Islands,TCA,AMRO,6380,16478.124,0,0,0,36,92.98,0,0,0,5410,970,26,10,5133,1247,17,19
Tuvalu,TUV,WPRO,20,169.607,0,0,0,0,0,0,0,0,0,20,0,0,11,9,0,0
Uganda,UGA,AFRO,169051,369.583,0,0,0,3630,7.936,0,0,0,50154,118897,1712,1918,44769,124282,87,3543
Ukraine,UKR,EURO,5177217,11838.033,44137,100.922,0,109206,249.706,161,0.368,0,458024,4719193,32122,77084,1716692,3460525,100365,8841
United Arab Emirates,ARE,EMRO,1026566,10379.416,2109,21.324,0,2345,23.71,3,0.03,0,612201,414365,480,1865,431162,595404,827,1518
United Republic of Tanzania,TZA,AFRO,39440,66.026,99,0.166,0,845,1.415,0,0,0,27111,12329,194,651,3870,35570,256,589
United States of America,USA,AMRO,94965623,28690.291,346532,104.692,79340,1047392,316.43,3081,0.931,1220,13979771,80985852,581485,465907,80718259,14247364,824917,222475
Uruguay,URY,AMRO,985422,28367.835,1270,36.56,0,7485,215.474,12,0.345,0,240894,744528,4597,2888,506970,478452,6774,711
Uzbekistan,UZB,EURO,244218,729.68,98,0.293,19,1637,4.891,0,0,0,16491,227727,341,1296,163736,80482,1302,335
Vanuatu,VUT,WPRO,11950,3890.671,0,0,0,14,4.558,0,0,0,8674,3276,10,4,8942,3008,5,9
Venezuela (Bolivarian Republic of),VEN,AMRO,544687,1915.488,377,1.326,67,5814,20.446,0,0,0,2393,542294,236,5578,85361,459326,2861,2953
Viet Nam,VNM,WPRO,11476908,11790.708,9289,9.543,0,43147,44.327,1,0.001,0,5038938,6437970,21878,21269,11360580,116328,40288,2859
Wallis and Futuna,WLF,WPRO,761,6766.85,0,0,0,7,62.244,0,0,0,311,450,6,1,171,590,6,1
Yemen,YEM,EMRO,11935,40.015,1,0.003,0,2157,7.232,0,0,0,3845,8090,1047,1110,6980,4955,936,1221
Zambia,ZMB,AFRO,333503,1814.098,116,0.631,0,4017,21.851,0,0,0,75781,257722,3436,581,293464,40039,1866,2151
Zimbabwe,ZWE,AFRO,257342,1731.436,53,0.357,0,5599,37.671,0,0,0,174466,82876,3611,1988,123121,134221,3052,2547
